complete 2018, 2017
eke out		пополнять  (сбережения) , увеличивать  (доход)  растягивать  (ресурсы) пробавляться, с трудом зарабатывать на жизнь, поддерживать существование  [ iːk ]
deviance		сущ.; =  deviancy, психол. девиантность, девиантное поведение ,неправильность, аномальность [ 'diːvɪən(t)s ]
idiosyncratic		отличительный, характерный, уникальный ,идиосинкратический, идиосинкразический [ ˌɪdɪəsɪŋ'krætɪk ]
assumption		ринятие на себя  (обязанностей) , вступление  (в должность)    принятие на себя долгов предъявление прав; захватпритворство высокомерие, надменность, заносчивость [ ə'sʌmpʃ(ə)n ]
leisure		 досуг, свободное время  свободный [ 'leʒə ]
engage		 (политически) ангажированный, занимающий определённую (идеологическую) позицию [ ˌɔngʌ'ʒeɪ ]
authentic		аутентичный, истинный, настоящий, подлинный, авторитетный, надёжный верный, достоверный [ ɔː'θentɪk ]
contrived		 неестественный, напускной, натянутый  Syn:  far-fetched [ kən'traɪvd ]
constitute		  составлять основывать; учреждать, создавать вводить в силу, принимать  (закон)  сделать, произвести официальное назначение; назначить [ 'kɔn(t)stɪtjuːt ]
perpetuate		увековечивать; сохранять навсегда [ pə'peʧueɪt ] 
strangeness		эксцентричность, странность;чудаковатость; оригинальность; своеобразие [ 'streɪnʤnəs ]
burgeon		пускать почки, давать ростки, распускаться out -пышно расти, разрастаться , бутон; почка; росток [ 'bɜːʤ(ə)n ]
distinction		  различение, распознавание; разграничение отличие,уважение, признание,знак отличия, награда высокие качества, исключительность   отлично  (отметка)  [ dɪ'stɪŋkʃ(ə)n ] 
taste		вкус, понимание; манера, стиль склонность, пристрастие пробовать (на вкус); отведать пережить, испытать, вкусить, познать   производить впечатление; [ teɪst ] 
corpus		свод  (законов) ; собрание  (сочинений)  корпус  (текстов)  основной капитал тело, туловище  сущ.; лат.; мн.  corpora  [ 'kɔːpəs ]
provenance		происхождение, источник Syn:  spring, source  [ 'prɔv(ə)nən(t)s ]
tie		лента, верёвка, шнурок галстук; ( ties)   полуботинки со шнурками связь, узы взаимодействие, связь обуза, тягота равный счёт   игра вничью пучок  (волосы) коса, косичка связка завязывать, привязывать, связывать скреплять сравнять счёт,  мешкать, медлить; плестись, набрасываться на  (кого-л.) [ taɪ ]
preposition		предлог Gram: [ ˌprepə'zɪʃ(ə)n ]
sift		отсеивать, просеивать щательно рассматривать, анализировать подвергать испытанию; подробно допрашивать  просеивание, отсев, просеиваемый материал; продукт отсеивания [ sɪft ]
Dutchman		  нидерландец; голландец немец голландское судно [ 'dʌʧmən ]
thistle		чертополох цветок чертополоха  (как эмблема Шотландии)  [ 'θɪsl ] 
tranquillity		спокойствие; невозмутимость; безмятежность [ træŋ'kwɪlətɪ ]
suburbia		предместья и их жители; пригороды [ sə'bɜːbɪə ]
chic		шик, изящество, элегантность  модный, нарядный, роскошный, шикарный chic sale  — амер.; эвф. уборная (во дворе)  [ ʃiːk ]
cosset		любимец; баловень;ягнёнок, выкормленный искусственно [ 'kɔsɪt ]
embankment		насыпь, дамба,сооружение насыпи, дамбы, вала набережная [ ɪm'bæŋkmənt ], [ em- ]
mound		насыпь; холм насыпать холм; сооружать насыпь [ maund ]
mole		крот  родинка, родимое пятно бурав кротового плуга дамба, запруда, плотина грамм-молекула, моль  [ məul ]
disfigure		обезображивать, уродовать; портить [ dɪs'fɪgə ]
halved		средний; половинчатый [ hɑːvd ]
undisguised		нескрываемый, открытый, явный; непритворный [ ˌʌndɪs'gaɪzd ]
regard		as)   расценивать, рассматривать; считать, относиться внимание, забота расположение, уважение; *s)   привет, поклон; пожелания касательство, отношение, связь; касаться , иметь отношение принимать во внимание, внимательно смотреть  (на кого-л. / что-л.) , разглядывать [ rɪ'gɑːd ]
captivity		плен; пленение, захват [ kæp'tɪvətɪ ] 
ancestor		прародитель, предок прототип, прообраз [ 'ænsəstə ]
fortunately		счастливо, к счастью [ 'fɔːʧ(ə)nətlɪ ]
namely		а именно, то есть [ 'neɪmlɪ ]
hardly		едва ли, вряд ли; почти не, едва, еле, насилу  тяжело, с трудом  резко, грубо, [ 'hɑːdlɪ ]
taunt		  насмехаться, говорить колкости дразнить  насмешка [ tɔːnt ]
gauge		мера, масштаб, размер,  критерий, способ оценки   измерять,оценивать собирать в складки  (ткань)  [ geɪʤ ]
blaze		гореть ярким пламенем   сверкать, сиять вспыхнуть яркий огонь, пламя    отметина, делать отметки на деревьях; разглашать, обнародовать [ bleɪz ]
lodestone		(lode) магнетит, магнитный железняк [ ləud ]
matriarchal		 матриархальный [ ˌmeɪtrɪ'ɑːk(ə)l ]
superficial		  внешний, неглубокий, поверхностный   кажущийся, мнимый двухмерный [ ˌs(j)uːpə'fɪʃ(ə)l ]
coincidental		совпадающий [ kəuˌɪn(t)sɪ'dent(ə)l ]
aid		аппарат, устройство   deaf / hearing aid  — слуховой аппарат -s налоги вспомогательные средства; пособия ассистент, помощник помощь, поддержка помогать [ eɪd ] 
fall off		уменьшаться, ослабевать   ухудшаться не слушаться руля []
lie off		стоять на некотором расстоянии временно прекратить работу []
coelacanth		латимерия a large, bony marine fish with a three-lobed tail fin and fleshy pectoral fins.[sēləˌkanTH]
project		выдаваться, выступать   выбрасывать, выпускать  (снаряд)  проектировать, разрабатывать,прогнозировать, предполагать проект, замысел  [ 'prɔʤekt ] 
recline		склоняться, нависать облокачиваться; склоняться,укладывать, откидывать назад,[ rɪ'klaɪn ]
soar		  высота  парить, up   (стремительно) повышаться вздыматься; возвышаться планировать, совершать парящий полёт [ sɔː ]
tycoon		сёгун  (в Японии)  разг. промышленный или финансовый магнат [ taɪ'kuːn ]
pauper		бедный, бедняк, неимущий, нищий получающий пособие по бедности [ 'pɔːpə ]
live within his means		жить по средствам []
reindeer		северный олень [ 'reɪndɪə ]
lifespan		 продолжительность жизни [ 'laɪfspæn ]
as opposed to		в отличие от  чего-л. , в противоположность  чему-л.  []
comprehension		понимание; осмысление,  способность понимать,охват, полнота содержание понятия [ ˌkɔmprɪ'hen(t)ʃ(ə)n ]
to some degree		до некоторой степени []
declining		идти к концу; приходить в упадок;меньшаться, идти на убыль;падать морально отклонять, давать вежливый отказ; падение, спад; упадок, конец, закат склон, уклон ухудшение спускаться вниз [ dɪ'klaɪn ]
realm		  королевство; государство сфера, область [ relm ]
evolve		  эволюционировать, развиваться развёртывать, раскручивать; развивать,   выявлять, обнаруживать;мат. извлекать корень [ ɪ'vɔlv ]
enthral		покорять, порабощать очаровывать, увлекать, захватывать [ ɪn'θrɔːl ], [ en- ]
fast pace		скорый, быстрый шаг []
bounce		прыжок; отскок упругость хвастовство; преувеличение; хвастливая ложь подпрыгивать; отскакивать увольнять  , выгонять ; отвергать(поклонника) устраивать кому-л. разнос вламываться бах  (неожиданно, вдруг)  [ baun(t)s ] 
perpetuate		 увековечивать; сохранять навсегда [ pə'peʧueɪt ]
sap		  сокжизненные силы, жизненные соки; жизнеспособность  амер.; разг. резиновая дубинка лишать сока; сушить, иссушать сапа, подкоп; крытая траншея подрывать, изматывать подкрадываться незаметно дурак, олух, болван зубрила, ботаник  корпеть [ sæp ]
morning glory		(+vine) вьюнок пурпурный, ипомея  (лат.  Ipomoea)   [ 'mɔːnɪŋˌglɔːrɪ ]
vine		виноградная лоза вьющееся или ползучее растение [ vaɪn ] 
encounter		случайная встреча первый опыт столкновение, стычка неожиданно) встретиться, столкнуться [ ɪn'kauntə ], [ en- ] 
polyphemus moth		Полифемовая бабочка [] 
consume		(away)   съедать, поглощать истреблять, уничтожать быть охваченным тратить, расточать хиреть, чахнуть [ kən'sjuːm ]
undergo		испытывать, переносить подвергаться [ ˌʌndə'gəu ]
convenient		  удобный, подходящий; пригодный близкий, находящийся под рукой [ kən'viːnɪənt ]
winding		бессвязный, хаотичный, беспорядочный извилистый; вьющийся; кривая линия, кривой путь   наматывание, намотка хитрости, околичности   извилина, изгиб, поворот [ 'waɪndɪŋ ]
daring		смелость; отвага  бесстрашный, мужественный,дерзкий открытый, обнажающий тело    (о платье)  [ 'deərɪŋ ]
peg		колышек деревянный гвоздь затычка долька цитрусовых сигнал семафора металлический стержень, воен.; жарг. заряд джин с содовой молочный зуб нога протез, деревянная нога сильный удар вытянутой рукой вбивать, вколачивать прикреплять огораживать колышками устанавливать цены или стоимость искусственно поддерживать   (курс)  классифицировать бросать, швырять протыкать [ peg ] 
peg away		упорно работать, корпеть над  (чем-л.)  []
peg down		связывать, стеснять, ограничивать устанавливать низкие цены; не давать ценам расти []
peg out		выдохнуться; потерять сознание; умереть; выйти из строя  повесить  (бельё)  разориться;убить шар  (в крокете) []
strand		  прядь  (каната),нитка бус, жемчуга ,длинный локон, прядь, порвать одну или несколько прядей,   вить, крутить, скручивать, плести, жила  (кабеля)  ,поэт. прибрежная полоса, берег   сесть на мель   посадить на мель выбросить на берег   поставить в затруднительное финансовое положение [ strænd ]
pleas		-e мольбы []
suggestive		вызывающий мысли намекающий на что-л. непристойное; неприличный относящийся к внушению, гипнозу [ sə'ʤestɪv ]
affinity		  близость, родство влечение, тяга свойство, родство по браку   сходство, похожесть биол. взаимодействие между антигеном и антителом [ ə'fɪnətɪ ] 
fortitude		сила духа, стойкость  Syn: courage [ 'fɔːtɪt(j)uːd ], [ -ʧuːd ] 
aptitude		  пригодность; уместность склонность сообразительность, способность  Syn: genius [ 'æptɪt(j)uːd ]
disparity		неравенство; несоответствие; несоразмерность [ dɪs'pærətɪ ]
dude		"дуд"  (житель восточной части США или горожанин, который проводит свой отпуск на ранчо в западной части США)  пижон, франт, денди парень, чувак, старик, братан; dude up вырядиться, разодеться клёво! круто! мощно![ djuːd ]
presume		предполагать, полагать; допускать отважиться, осмелиться притворяться (up)on)   злоупотреблять [ prɪ'zjuːm ]
mount		  садиться (на), залезать, взбираться взлетать вверх,  подниматься, восходить покрывать  (оплодотворять самку)  снабжать верховыми лошадьми или транспортным средством монтировать, устанавливать насаживать, накалывать   ставить  (спектакль)  быть вооружённым пушками поднимать, воодушевлять; подложка; паспарту оправа  (драгоценного камня) основа,   животное под седлом велосипед лафет, станок высокий холм, гора [ maunt ] 
coin		создавать неологизмы  (новые слова и выражения)  измышлять, выдумывать; замышлять чеканить; штамповать пуансон, чекан, штемпель монета [ kɔɪn ]
reap		жать, пожинать, собирать урожай получать результат [ riːp ] 
condemn		осуждать, порицать приговаривать, выносить приговор обрекать   браковать, признавать негодным конфисковывать забивать  (окна, двери)  [ kən'dem ]
cautious		осторожный, осмотрительный; предусмотрительный [ 'kɔːʃəs ]
chiefly		 главным образом, особенно, в основном [ 'ʧiːflɪ ] 
pastime		 времяпрепровождение, развлечение, забава, увеселение; игра [ 'pɑːstaɪm ]
acclaim		 шумное приветствие громко аплодировать; шумно приветствовать   заявлять, объявлять, провозглашать [ ə'kleɪm ]
threat		опасность, угроза [ θret ] 
turtle weed		травяная черепаха []
seeweed		водоросли []
goby		 бычок  (рыба)  [ 'gəubɪ ]
staghorn		 платицериум, олений рог, плоскорог [ 'stæghɔːn ]
odor, odour		запах  (обычно неприятный)  аромат, благоухание особенность, душок, налёт, привкус [ 'əudə ]
habitat		родина, место распространения, ареал [ 'hæbɪtæt ]
seemingly		по-видимому , на вид, по внешнему виду  Syn: apparently,   to all appearance  [ 'siːmɪŋlɪ ]
quotation		цитирование цитата стоимостsuggestiveь, цена;котировка, курс [ kwə'teɪʃ(ə)n ]
erratic		изменчивый, непостоянный; непредсказуемый эксцентричный, чудаковатый, странный блуждающий  чудак, сумасброд, оригинал  Syn: crank [ ɪ'rætɪk ], [ er'- ]
attributable		 приписываемый  (чему-л.) , относимый  (к чему-л.)  [ ə'trɪbjutəb(ə)l ]
occasionally		иногда, изредка, время от времени; подчас, порой [ ə'keɪʒ(ə)n(ə)lɪ ]
polio		полиомиелит, мн.polios   больной полиомиелитом [ 'pəulɪəu ]
consist		(in)   заключаться в чём-л. (of)   состоять, быть составленным из, (with)   совмещаться, совпадать, соответствовать состав, совокупность частей; структура, железнодорожный состав [ kən'sɪst ] 
Polyphemus		Polyphemus is the one-eyed giant son of Poseidon and Thoosa in Greek mythology, one of the Cyclopes described in Homer's Odyssey. His name means "abounding in songs and legends" []
moth		бабочка; ночная бабочка мотылёк [ mɔθ ]
convincingly		убедительно [ kən'vɪn(t)sɪŋlɪ ]
convenient		удобный, подходящий; пригодный   близкий, находящийся под рукой [ kən'viːnɪənt ]
undergo		  испытывать, переносить подвергаться  (чему-л.)  [ ˌʌndə'gəu ] 
undergoing change		претерпевает изменение []
rite		обряд, церемония ритуал, церемониал [ raɪt ]
daring		смелость; отвага; бесстрашие, мужество,бесстрашный, мужественный,открытый, обнажающий тело [ 'deərɪŋ ] 
winding		извилистый; вьющийся; петляющий ;извилина, изгиб, поворот наматывание, намотка кривая линия, кривой путь бессвязный, хаотичный,[ 'waɪndɪŋ ]
peg		колышек деревянный гвоздь затычка, втулка долька цитрусовых сигнал семафора колок металлический стержень, вокруг оси которого вращается юла заряд джин с содовой водой молочный зуб нога протез,вешалка; крючок сильный удар вытянутой рукой прикреплять колышком бросать, швырять   протыкать [ peg ] 
peg away		упорно работать, корпеть над  (чем-л.)  []
peg down		связывать, стеснять, ограничивать устанавливать низкие цены; не давать ценам расти []
peg out		выдохнуться; потерять сознание; умереть; выйти из строя повесить  (бельё)  разориться;убить шар  (в крокете) []
strand		прядь  (каната, троса) ;жила нитка бус, жемчуга бородка птичьего пера длинный локон, прядь волос порвать одну или несколько прядей  вить, крутить,вплетать, переплетать прибрежная полоса, берег сесть на мель посадить на мель оказаться на мели, без денег [ strænd ]
plea		  просьба; призыв, обращение; требование; предложение law-plea   судебный акт, процесс, тяжба заявление, сделанное в суде жалоба, прошение, иск возражение, апелляция повод, предлог, оправдание шотл. ссора, вражда; спор, выяснение отношений [ pliː ]
suggestive		  вызывающий мысли намекающий на что-л. непристойное; неприличный относящийся к внушению, гипнозу [ sə'ʤestɪv ] 
affinity		близость, родство сходство, похожесть сродство [ ə'fɪnətɪ ]
fortitude		сила духа, стойкость [ 'fɔːtɪt(j)uːd ], [ -ʧuːd ]
aptitude		пригодность; уместность склонность сообразительность, способность [ 'æptɪt(j)uːd ] 
disparity		неравенство; несоответствие; несоразмерность [ dɪs'pærətɪ ]
presume		предполагать, полагать; допускать отважиться, осмелиться притворяться (up)on); злоупотреблять  (чем-л.)  [ prɪ'zjuːm ]
coin		монета чеканить; штамповать измышлять, выдумывать; замышлять создавать неологизмы [ kɔɪn ]
toss up a coin		to spin a coin играть в орлянку решать пари подбрасыванием монеты to coin it in разг. зарабатывать много денег []
reap		  жать, пожинать, собирать урожай получать результат [ riːp ] 
prevalence		широкая распространённость, повсеместное существование ;уст. вес, сила, господство [ 'prev(ə)lən(t)s ]
condemn		осуждать, порицать приговаривать, выносить приговор обрекать браковать, признавать негодным конфисковывать  (контрабандные товары)забивать  (окна, двери)  [ kən'dem ]
goby		бычок  (рыба)  [ 'gəubɪ ]
odour (odor)		запах  (обычно неприятный)  аромат, благоухание особенность, душок, налёт, привкус [ 'əudə ] 
offensive		  обидный, оскорбительный   отвратительный, неприятный, противный агрессивный, наступательный,наступление, атака [ ə'fen(t)sɪv ]
deter		удерживать  (от чего-л.) ; отпугивать Syn: discourage [ dɪ'tɜː ] 
intricate		 запутанный, сложный, замысловатый; затруднительный  Syn: involved, tangled [ 'ɪntrɪkət ] 
infer		заключать; делать вывод   значить, обозначать, означать, подразумевать; наводить на мысль делать предположение, высказывать догадку [ ɪn'fɜː ]
drill		  дрель; перфоратор сверлить  (дыру) бурить, добывать застрелить  (кого-л.)  придавать вращательное движение подготовка, тренировка; упражнения, отработка строевые учения,тренировать, натаскивать отдавать точные приказы, строгие распоряжения приводить на запасной путь сеялка высаживать, сеять рядами разновидность западноафриканского бабуина, мандрил  [ drɪl ] 
decline		спускаться вниз   наклоняться, склоняться заходить  (о небесном теле)   идти к концу; приходить в упадок; ухудшаться уменьшаться, идти на убыль; спадать  падать морально отклонять, давать вежливый отказ;падение, спад; упадок, конец, закат   изнурительная болезнь   склон,[ dɪ'klaɪn ] 
erratic		изменчивый, непостоянный; непредсказуемый эксцентричный, чудаковатый, странный блуждающий  чудак, сумасброд, оригинал [ ɪ'rætɪk ], [ er'- ]
tangible		вещественный, материальный, осязаемый ясный; ощутимый, заметный; реальность, факт нечто ощутимое, реальное, осязаемое;[ 'tænʤəbl ] 
dormant		дремлющий, спящий потенциальный, скрытый находящийся в зимней спячке  бездействующий,нереализуемый; отложенный [ 'dɔːmənt ] 
regal		  королевский, царский   величественный, царственный [ 'riːg(ə)l ] 
interrogation		допрос   вопрос, вопросительное предложение передача сигнала [ ɪnˌterə'geɪʃ(ə)n ]
restatement		повторное заявление; подтверждение [ ˌriː'steɪtmənt ]
invariable		неизменный, неизменяемый; постоянный, стабильный, устойчивый [ ɪn'veərɪəbl ]
fatigue		усталость, утомление апатия, тяжёлая, утомительная работа atigue duty   нестроевой наряд, хозяйственная работа изматывать, изнурять, утомлять [ fə'tiːg ] 
arrangement		приведение в порядок; расположение; классификация;  договорённость, соглашение урегулирование переделка, переложение компоновка, составление; расстановка аранжировка монтаж [ ə'reɪnʤmənt ]
headstrong		настойчивый, своевольный, упрямый, упорный Syn: stubborn [ 'hedstrɔŋ ]
stunned		ошеломлённый, потрясённый [ 'stʌnd ]
stun		оглушить ударом   потрясти, ошеломить [ stʌn ] 
quarrel		  ссора; перебранка; раздоры причина спора, разногласий ссориться, ругаться,короткая, тяжёлая стрела для арбалета алмаз для резки стекла   долото  [ 'kwɔr(ə)l ] 
elaborate		тщательно, детально разработанный; продуманный; старательный, аккуратный; усердный   детально разрабатывать  придавать законченный вид производить; вырабатывать, перерабатывать [ ɪ'læb(ə)rɪt ] 
alike		точно так же, подобно, одинаково, похоже одинаковый; подобный, похожий [ ə'laɪk ] 
starling		скворец  водорез, волнорез; ледорез [ 'stɑːlɪŋ ]
chairman		председатель Syn:  president [ 'ʧeəmən ]
playwright		драматург [ 'pleɪraɪt ] 
surge		(на)хлынуть подъём, рост; всплеск подниматься, вздыматься большая волна; волны   волноваться  (о толпе)  мор. травить [ sɜːʤ ]
bluebird		 синешейка  (певчая птица)  [ 'bluːbɜːd ]
woodpecker		дятел [ 'wudˌpekə ]
roost		  (собираться объединяться ?)усаживаться на насест устраиваться на ночлег усаживаться, взгромождаться насест; курятник спальня; постель [ ruːst ] 
devour		жадно есть; глотать, давясь поглощать; уничтожать; разрушать снедать, мучить [ dɪ'vauə ]
gobble		жадно, быстро; пожирать   глотать, читать запоем кулдыкать  (об индюке)  [ 'gɔbl ]
repercussion		отдача  (после удара)  отражение, рефлексия отзвук; эхо ответное действие; влияние; последствия [ ˌriːpə'kʌʃ(ə)n ]
restatement		повторное заявление; подтверждение [ ˌriː'steɪtmənt ]
composer		композитор автор, сочинитель наборный автомат [ kəm'pəuzə ] 
nuisance		досада; неприятность надоедливый человек; зануда   невыносимое состояние, положение вещей неудобство, помеха [ 'njuːs(ə)n(t)s ] 
partition		  расчленение; деление, раздел, разделение распределение   линия раздела, граница отделение, секция,делить, разделять, расчленять ставить перегородку [ pɑː'tɪʃ(ə)n ] 
shortage		 нехватка, недостаток; дефицит   teacher shortage  — нехватка преподавателей [ 'ʃɔːtɪʤ ] 
severe		строгий, суровый; требовательный склонный осуждать; критически настроенный простой; без излишеств серьёзный, тяжёлый, сильный   трудный, тяжёлый;саркастический, едкий; резкий, колкий [ sɪ'vɪə ]
grace		готовность, расположение украшать   удостаивать, награждать грация, грациозность; изящество;with (a) good grace  охотно, с готовностью,достоинства, добродетели приличия рел. благодать милосердие, прощение; милость отсрочка, передышка молитва  (перед едой) разрешение на соискание учёной степени милость, светлость ( graces)   игра в серсо [ greɪs ]
scenic		живописный, красивый  сценический; театральный изображающий эпизод, сцену [ 'siːnɪk ]
decent		подходящий, пристойный   приличный, порядочный; славный, хороший; неплохой, сносный [ 'diːs(ə)nt ] 
gratify		  попустительствовать, потакать, потворствовать вознаграждать  удовлетворять; доставлять удовольствие; радовать [ 'grætɪfaɪ ]
cowardice		  трусость   малодушие; робость [ 'kauədɪs ] 
pinnacle		кульминационный пункт, апофеоз возносить вершина, пик остроконечная башенка, бельведер, шпиц украшать башенками [ 'pɪnəkl ] 
affair		(s)дела, вопросы происшествие, инцидент, дело   событие, мероприятие; явление штука, штуковина роман, любовная связь, амур(ы)[ ə'feə ] 
flaw		упущение, ошибка изъян, недостаток  трещина, щель, порок   повредить, испортить порыв ветра; шквал; вспышка ненастья уст. прилив, вспышка  [ flɔː ]
cardboard		картон картонный адуманный, неестественный, ненатуральный, ходульный  (о литературном персонаже)  [ 'kɑːdbɔːd ] 
unimpeded		беспрепятственный, свободный [ ˌʌnɪm'piːdɪd ]
eventual		  возможный, могущий случиться; конечный, окончательный [ ɪ'venʧuəl ], [ -tju- ] 
watermelon		арбуз [ 'wɔːtəˌmelən ]
yam		батат, сладкий картофель [ jæm ]
cane		тростник; камыш стебель тростника; лоза трость бить палкой вбивать знания, вдалбливать урок оплетать тростником; плести из тростника, камыша [ keɪn ]

















