17:30 Saturday, December 08, 2018
wigging		нагоняй, нахлобучка, разнос [ 'wɪgɪŋ ]
scoff		насмехаться над,осмеивать, поднимать на смех  насмешка, издёвка жадно есть, лопать, хватать, грабить  еда, жратва [ skɔf ]
fitfully		судорожно; порывисто, прерывисто, толчками, урывками, лихорадочно [ 'fɪtf(ə)lɪ ], [ -fulɪ ]
clammy		  холодный и влажный на ощупь вязкий, тягучий   клейкий, липкий, вязкий вялый, неторопливый, медлительный неприветливый, лишённый человеческой теплоты [ 'klæmɪ ]
endure		вынести, вытерпеть; выдержать   длиться; продолжаться, тянуться терпеть, сносить [ ɪn'djuə ], [ en- ] 
skive		увиливание, уклонение  (от)халтурное выполнение работы =  skive off   помчаться стрелой; ринуться; рвануться, алмазный гранильный круг стачивать  [ skaɪv ]
indignation		 негодование, возмущение Syn:  anger [ ˌɪndɪg'neɪʃ(ə)n ] 
wisp		пучок, жгут, клок клочок, обрывок; след, остаток, фрагмент метёлка   худенький, хрупкий человек [ wɪsp ]
bog		  болото, трясина  груб. сортир нечто запутанное смертный ужас; источник страха увязать, тонуть в трясине не мочь разобраться в ситуации, запутаться [ bɔg ]
despair		отчаяние; упадок духа; безнадёжность, безысходность   причина отчаяния   ( despair of)   падать духом, отчаиваться, терять надежду [ dɪ'speə ]
upturn		подъём, рост переворот, потрясение переворачивать направлять вверх [ 'ʌptɜːn ]
persist		упорствовать, настойчиво, упорно продолжать удерживаться, сохраняться, продолжать существовать; устоять [ pə'sɪst ] 
opaline		опалин матовое стекло опаловый цвет [ 'əup(ə)liːn ], [ -laɪn ]
flossy		шелковистый [ 'flɔsɪ ]
humpbacked		 горбатый [ 'hʌmpbækt ]
festive		 весёлый, праздничный, радостный [ 'festɪv ] 
flourish		цвести, расцветать; пышно расти процветать, преуспевать делать росчерк пером, цветисто выражаться  размахивать оружием в знак триумфа   хвастаться, рисоваться;  показные движения, салют  (перед поединком)расцвет, высшая точка развития [ 'flʌrɪʃ ]
wrench		тоска, боль  мучить, причинять страдание, боль wrench off / away   вывёртывать, вырывать   искажать  (факты) гаечный ключ [ ren(t)ʃ ]
bequeath		  завещать объявлять; говорить, заявлять; обозначать оплакивать, скорбеть [ bɪ'kwiːð ]
got into a spot of bother with		попасть в переделку попасть в беду []
haul		  тащить, тянуть   везти, перевозить; транспортировать;волочить; haul up вызывать в суд арестовывать round / to   меняться, менять направление волочение, тяга перевозка, транспортировка добыча, трофеи [ hɔːl ] 
wind up		заводить, приводить в возбуждённое состояние подтягивать  (дисциплину)  доводить до конца   уладить, разрешить  (вопрос)    ликвидировать []
prong		остриё  (зуба, рога, скалы)  зубец  направление рукав реки  штырь,  член (муж),переворачивать вилами прокалывать, протыкать[ prɔŋ ]
purveyor		поставщик Purveyor to their Majesties  — поставщик их величеств [ pə'veɪə ], [ pɜː'- ]
mischief		вред; повреждение; убытки, ущерб   беда, зло озорство, проказы источник огорчений, источник неприятностей бедокур, озорник [ 'mɪsʧɪf ]
marauder		 мародёр, грабитель [ mə'rɔːdə ]
astound		изумлять, поражать [ ə'staund ]
study		изучение, исследование   рабочий кабинет глубокая задумчивость; мечтательность, фантазии набросок, эскиз, этюд намерение, цель   изучать, исследовать заботиться стремиться [ 'stʌdɪ ]
hump		  быстро двигаться, мчаться  бугорок, кочка; пригорок горный хребет,   решающий, критический момент; тоска, плохое настроение,   горбить, сутулить  (спину)  напрягаться; действовать энергично нагонять тоску; трахаться [ hʌmp ] 
tireless		 неутомимый, неустанный [ 'taɪələs ]
uncanny		сверхъестественный, необъяснимый, странный опасный, ненадёжный [ ʌn'kænɪ ]
impersonation		  подражание, пародирование, передразнивание воплощение, олицетворение [ ɪmˌpɜːs(ə)'neɪʃ(ə)n ]
burrow		нора червоточина рыть нору, ход прятать; погружать; уткнуть прятаться; погружаться; рыться, копаться [ 'bɜːrəu ]
trapdoor		люк, опускная дверь лазейка  (слабое место программы)  вентиляционная дверь [ ˌtræp'dɔː ]
dodge		прятаться увиливать, хитрить, ловчить, маневрировать обман, уловка, хитрость; проделка обманное движение, финт   увёртываться, уклоняться  [ dɔʤ ]
cellar		подвал; погреб запас вин, коллекция вин   хранить в подвале,скрывать, утаивать  [ 'selə ] 
mullion		 средник  (окна или двери)  устанавливать средник; разделять средником [ 'mʌlɪən ]
thatched cottage		бунгало, thatched roof  — соломенная крыша [ θætʃt ]
crisp		рассыпчатый, хрустящий жёсткий, твёрдый ясно очерченный, выраженный;решительный, завитой, кудрявый хрустеть   покрываться рябью завиваться,хрустящий картофель, чипсы [ krɪsp ]
wreath		  венок, гирлянда завиток, кольцо  (дыма)  шотл. сугроб [ riːθ ]
curvy		изогнутый, кривой [ 'kɜːvɪ ]
A curvy sort of woman with a pretty face was serving a bunch of rowdy warlocks up at the bar.
tankard		высокая пивная кружка  (часто с крышкой)  диал. колокольчик овцы [ 'tæŋkəd ]
flurry		  шквал; сильный порыв ветра  волновать; будоражить; вызывать возбуждение, суету [ 'flʌrɪ ]
snowflake		снежинка   snowflake curve  —мат. контур снежинки [ 'snəufleɪk ]
gilly		желтофиоль (садовая) [ 'ʤɪlɪ ]
mull		подогревать вино или пиво с пряностями мягкий гумус сорт тонкого муслина (over)   обдумывать, размышлять [ mʌl ]
mead		медовуха (mulled mead) луг  Syn: meadow  [ miːd ]
ta		межд.; брит.; разг. спасибо  Syn: thank-you, thankee [ 'θæŋkɪ ], thanks [ tɑː ]
currant		  смородина    коринка; сабза  (сорта бессемянного изюма)  [ 'kʌr(ə)nt ]
rum		ром спиртной напиток странный, чудной, подозрительный  [ rʌm ] 
neck of the woods		 местность []
eavesdropper		подслушивающий, соглядатай [ 'iːvzˌdrɔpə ]
demur		  возражение колебание, сомнение колебаться, не решаться; сомневаться возражать, протестовать [ dɪ'mɜː ]
mead		 медовуха  луг  [ miːd ] Syn:  meadow  луг, луговина; низина, пойменная земля [ 'medəu ] 
ringleader		 зачинщик, вожак, главарь [ 'rɪŋˌliːdə ] 
torment		мучить; причинять боль досаждать, изводить, раздражать искажать мука, мучение  муки ада источник мучений орудие пытки [ 'tɔːment ]
tireless		неутомимый, неустанный  Syn:  indefatigable, untiring [ 'taɪələs ] 
henceforth		с этого времени, впредь [ ˌhen(t)s'fɔːθ ] 
turncoat		ренегат; перебежчик [ 'tɜːnkəut ] 
worship		  поклоняться, почитать благоговеть, боготворить посещать церковь поклонение, почитание вероисповедание, богослужение, культ [ 'wɜːʃɪp ]
harp		занудствовать, завести волынку надоедливо твердить о,  арфа губная гармоника [ hɑːp ]
head cold		 насморк []
sewer		сточная труба; коллектор, канализационная труба  обеспечивать, снабжать канализацией швец; швея [ 'səuə ]
evasively		 уклончиво [ ɪ'veɪsɪvlɪ ]
dint		след, вмятина, отпечаток оставлять след, вмятину, отпечаток [ dɪnt ]
rehearsed		 отрепетированный [ rɪ'hɜːst ]
stricken		  поражённый  (болезнью, горем)   раненый, больной [ 'strɪk(ə)n ] 
interject		 вставлять замечания; мимоходом замечать, прерывать [ ˌɪntə'ʤekt ]
luxuriously		с наслаждением роскошно, пышно, богато; превосходно [ lʌg'ʒu(ə)rɪəslɪ ], [ 'zjuər- ] 
plainly		понятно, очевидно, ясно   откровенно, прямо, открыто   просто, безыскусно [ 'pleɪnlɪ ]
trench		  канавка, углубление окоп, траншея океанская впадина котловина в горах рыть рвы, канавы, окопы, траншеи вскапывать прорезать  (желобки, борозды)  посягать на [ tren(t)ʃ ] 
smattering		поверхностное знание smattering of the language.  — немного выучились языку, малое количество a smattering of applause  — редкие аплодисменты [ 'smæt(ə)rɪŋ ] 
swollen		вздутый, раздутый; опухший непомерно высокий  (о ценах)  [ 'swəulən ]
uphold		поддерживать, помогать   подтверждать, одобрять сохранять, удерживать  (на том же уровне)  поднимать [ ʌp'həuld ]
fellowship		товарищество, братство чувство товарищества, дружеские отношения членство  стипендия  [ 'feləuʃɪp ] 
chomp		чавкать; хрупать, громко жевать [ ʧɔmp ]
boar		 хряк ,wild boar  — кабан, вепрь boarhound :) [ bɔː ] 
lettuce		салат-латук разг. деньги, "зелёные", "капуста" [ 'letɪs ]
spell		промежуток времени  приступ   (рабочая) смена дать передышку, срок, период ;заклинание  заколдовывать,   писать или произносить  (слово)  по буквам означать, влечь за собой [ spel ]
marauding		 мародёрство, грабительство  мародёрский, хищнический, грабительский [ mə'rɔːdɪŋ ]
mince		  крошить, рубить   пропускать через мясорубку смягчать, умалять; преуменьшать держаться жеманно   говорить очень чётко, с хорошей дикцией и произношением семенить ногами, ступать маленькими шажками   фарш [ mɪn(t)s ]
tinsel		блёстки, мишура ткань с блестящей нитью мишурный; показной украшать мишурой, блёстками придавать внешний лоск, блеск [ 'tɪn(t)s(ə)l ] 
whirl		вертеться; кружиться; вращаться   нестись, мчаться,уносить, увлекать бросать, кидать быть в смятении суматоха, суета,[ (h)wɜːl ]
sullen		замкнутый, сердитый, угрюмый печальный, мрачный; зловещий; гнетущий медленно текущий [ 'sʌlən ] 
reluctantly		с неохотой, неохотно, против желания [ rɪ'lʌkt(ə)ntlɪ ]
dig in		разг. жадно начинать есть окапываться прятать, защищать  (в окопах)проявлять терпение, стойко переносить трудности упрочивать, укреплять []
sequin		блёстка на платье [ 'siːkwɪn ]
luncheon		ланч  (преимущественно официальный)  [ 'lʌnʧən ]
roving		блуждающий  (о взгляде и т. п.)  бродячий, кочевой, кочующий [ 'rəuvɪŋ ]
utter		издавать звук; произносить излагать, выражать словами полный, совершенный, абсолютный   решительный, определённый [ 'ʌtə ]
tripe		рубец или желудок разг. вздор, дрянь, чепуха, чушь уст.; =  bag of tripe   дрянь, сволочь [ traɪp ] 
percussion		  столкновение  (двух тел) , удар; сотрясение  мед. выстукивание, перкуссия муз.; употр. с гл. во мн. ударные инструменты [ pə'kʌʃ(ə)n ]
unaware		  не знающий, не ведающий   неосторожный, опрометчивый, безрассудный [ ˌʌnə'weə ]
lacking		лишённый, не имеющий  (чего-л.)  недостающий, отсутствующий [ 'lækɪŋ ]
tart		резкий, колкий, ядовитый кислый; терпкий; едкий раздражительный, саркастический пирог  (с фруктами) разг. жена; подружка  проститутка мальчик на содержании у педераста сделать интереснее принарядить, украсить вырядиться, принарядиться [ tɑːt ] 
good deal		 значительное количество, много []
devious		блуждающий; слоняющийся;удалённый,бегать, носиться, резво скакать  отдалённый; уединённый; изолированный окольный, кружный, обходной заблудший, сбившийся с пути неискренний; нечестный, непорядочный [ 'diːvɪəs ]
visor		забрало козырёк  (фуражки)  маска, маскировка [ 'vaɪzə ]
flagon		графин, большая бутыль со сплюснутыми боками [ 'flægən ]
mead		 медовуха  луг  Syn: meadow [ miːd ]
scurvy		презренный, жалкий низкий, подлый цинга [ 'skɜːvɪ ] 
cur		  дворняжка, непородистая (злая) собака грубиян, хам, невоспитанный человек трус, малодушный человек [ kɜː ]
grave		произвести впечатление серьёзный, веский, важный; мрачный, печальный могила; захоронение смерть, гибель вырезать, гравировать очищать подводную часть судна   [ greɪv ] 
announcement		объявление, сообщение; извещение, уведомление [ ə'naun(t)smənt ]
flown		управляемый  (о полёте)  перевозимый по воздуху [ fləun ] 
tamper		вмешиваться  портить, наносить ущерб подделывать подкупать, влиять на трамбовка; пест оболочка атомной бомбы [ 'tæmpə ] 
subject		подчинять, покорять   предрасполагать, склонять   представлять, вносить  зависимый, подвластный, подневольный, подчинённый тема, предмет разговора субъект, человек [ 'sʌbʤekt ]
refuge		убежище; прибежище   давать, предоставлять убежище служить прибежищем [ 'refjuːʤ ]
ward		(off)   отражать, отвращать  (удар, опасность)  помещать в больницу; сажать  в тюрьму ;защищать, охранять ward off держать  (кого-л.)  на расстоянии опекунство, опека тюремная камера внутренний дворик административный район города [ wɔːd ] 
bonfire		костёр [ 'bɔnˌfa(ɪ)ə ]
scamper		бегать, носиться, резво скакать быстрый бег; пробежка беглое прочтение, быстрый просмотр [ 'skæmpə ] 
crumble		раскрошить, растолочь, растереть сыпаться, осыпаться; обваливаться терпеть крах, разрушаться, гибнуть [ 'krʌmbl ]
log		бревно; колода; чурбан разрез буровой скважины ;заготавливать пилить лес на стройматериалы ;вносить в журнал  проходить по лагу  (расстояние)  [ lɔg ]
lofty		высокомерный, надменный; горделивый ;очень высокий далёкий, отдалённый благородный, великодушный величественный [ 'lɔftɪ ]
maddening		 сводящий с ума   maddening pain  — безумная боль [ 'mæd(ə)nɪŋ ]
resentful		обиженный; возмущённый обидчивый [ rɪ'zentf(ə)l ], [ -ful ] 
despair		  отчаяние; упадок духа; безнадёжность, безысходность of)   падать духом, отчаиваться, терять надежду [ dɪ'speə ]
wisp		пучок, жгут, клок   худенький, хрупкий человек клочок, обрывок; след, остаток, фрагмент   метёлка [ wɪsp ]
astound		изумлять, поражать  Syn: pamaze, strike dumb [ ə'staund ] 
shoelace		шнурок для ботинок   to knot / tie a shoelace  — завязать шнурок [ 'ʃuːleɪs ]
detour		окольный путь, обход; объезд [ 'diːtuə ]
plinth		плинтус , цоколь; постамент [ plɪnθ ]
cram		впихивать, втискивать переполнять; наполнять доверху, полностью   откармливать на убой спешно готовиться к экзамену, зубрить пичкать, впихивать врать с три короба,пришпоривать лошадь вламываться, врываться давка, толкотня, толпа бессистемные знания, полученные в спешке зубрёжка [ kræm ] 
immense		  безмерный, очень большой, огромный обширный, очень просторный, необъятный; беспредельный, бесконечный классный, крутой, потрясающий [ ɪ'men(t)s ] 
fathom		понимать; исследовать; разузнавать; выяснять, обхватить руками фатом, фадом, морская сажень способность быстрого восприятия; понимание [ 'fæðəm ] 
shirty		раздражённый, рассерженный   похожий на рубашку, рубашечный [ 'ʃɜːtɪ ]
imperceptible		 незаметный, незначительный [ ˌɪmpə'septəbl ]
avert		  отворачиваться; отводить  (взгляд)  отвращать, предотвращать; отводить  (удар, опасность)  [ ə'vɜːt ]
hitherto		до настоящего времени, до сих пор [ ˌhɪðə'tuː ]
hold at bay		держать кого-л. в страхе, не подпускать []
keep smb. at bay		отчаянно защищаться []
loon		бездельник, негодяй неотёсанный человек, деревенщина парень полярная гагара  [ luːn ]
asylum		убежище, пристанище, прибежище приют  (благотворительное учреждение для инвалидов, одиноких, психически больных)  [ ə'saɪləm ]
outlast		  пережить  (кого-л. / что-л.)  прожить, протянуть  (в течение какого-л. времени)    длиться дольше, чем  (что-л.) ; превосходить по длительности продержаться дольше [ ˌaut'lɑːst ]
closure		закрытие; завершение; прекращение облегчение, исцеление герметизация застёжка   бутылочная крышка смыкание соглашение  закрывать дискуссию, прения, обсуждение; прерывать оратора [ 'kləuʒə ] 
rampage		неистовствовать, буйствовать, бушевать; метаться неистовство, ярость; буйство [ ræm'peɪʤ ]
altered		усовершенствованный, alter изменять; менять; видоизменять, вносить изменения, переделывать кастрировать, холостить  (скот)  [ 'ɔːltə ] 
envoy		делегат, посланец, представитель; агент, доверенное лицо  Syn: minister plenipotentiary  [ 'envɔɪ ] 
sublet		 передавать в субаренду, сдавать в поднаём  Syn:  sublease [ sʌb'let ]
prosecutor		обвинитель, прокурор   исполнитель какой-л. работы; человек, занимающийся каким-л. делом истец 
poo		каки, какашки ка-ка, каканье какать I want to do a poo.  — Я хочу какать. dog poo  — собачьи какашки [ puː ]
reproachfully		укоризненно, осуждающе, неодобрительно [ rɪ'prəuʧf(ə)lɪ ], [ -fulɪ ]
distress		затруднительное положение, стеснённые обстоятельства бедствие, бедственное положение нужда, нищета   горе, несчастье,физическая боль, недомогание   причинять страдание, горе; мучить, терзать доводить до нищеты искусственно старить [ dɪ'stres ]
notch		делать запись, отмечать, записывать делать метку; прорезать выемка, метка, зарубка; зазубрина; борозда, желобок, разг. степень; предел, уровень, граница [ nɔʧ ] 
curtsy		приседание, реверанс приседать, делать реверанс [ 'kɜːtsɪ ]
chancellor		  канцлер; премьер-министр номинальный глава университета [ 'ʧɑːn(t)s(ə)lə ]
abiding		постоянный; неизменный; прочный  Syn:  permanent [ ə'baɪdɪŋ ]
groom		  конюх; грум  сокр. от  bridegroom   жених придворный слуга  работник мужчина ходить за лошадью, чистить лошадь готовить к определенной должности, карьере [ gruːm ] 
attaboy		at-a-boy   молодец!  [ 'ætəbɔɪ ]
solicitor		солиситор, стряпчий адвокат,подготавливающий дела для барристера  и выступающий только в судах низшей инстанции, агент фирмы по распространению заказов, коммивояжёр главный юрисконсульт муниципалитета [ sə'lɪsɪtə ]
barrister		барристер  (адвокат, имеющий право выступать в высших судах)  [ 'bærɪstə ]
hypocrite		 лицемер, ханжа [ 'hɪpəkrɪt ]
implication		вовлечение, привлечение; включение замешанность, причастность, соучастие следствие, вывод; последствия,то, что подразумевается; подтекст [ ˌɪmplɪ'keɪʃ(ə)n ]
compulsion		принуждение, насилие [ kəm'pʌlʃ(ə)n ] 
womb		 анат. матка лоно; поэт. мрак исток, начало; in the womb of time когда-нибудь в далёком будущем [ wuːm ]
augment		усиливать; увеличивать, расширять прирост, прибавление аугмент, приращение  [ 'ɔːgmənt ] 
wasting		изнурительный  (о болезни)  опустошительный; опустошающий, разорительный wasting war  — опустошительная война [ 'weɪstɪŋ ]
snuff		резко пресекать, прерывать разг. прикончить snuff it дать дуба, загнуться ; понюшка нюхательный табак что-л. очень маленькое, незначительное    нюхать табак нюхать, обнюхивать;вынюхивать;огарок бесполезный остаток шотл. вспышка раздражения snuff out   тушить  (свечу)  [ snʌf ]
tribute		коллективный дар, подношение, награда дань; подать обязанность платить дань, положение должника [ 'trɪbjuːt ]
oversee		  наблюдать, надзирать; следить,увидеть случайно, подсмотреть [ ˌəuvə'siː ]
vein		   стиль, тон настроение, душевное состояние , вена; кровеносный сосуд ход  (мысли) , источник [ veɪn ] 
fervent		горячий, пламенный; пылкий, страстный; жгучий [ 'fɜːv(ə)nt ]
midst		середина  средь [ mɪdst ] 
go ballistic		прийти в ярость  Syn: go berserk, go postal []
vault		прыгать, перепрыгивать  (опираясь на) вольтижировать  ; подвал, погреб свод возводить свод  изгибаться [ vɔːlt ] 
tell off		 разг. ругать; отчитывать, бранить, разносить производить строевой расчёт отсчитывать, отбирать считать, пересчитывать количество []
wash down		запивать  (еду) The meal was so bad that we had to wash it down with cheap wine. []
outcome		  исход, итог, последствие, результат выход, выпускное отверстие [ 'autkʌm ]
tumultuous		возбуждённый, волнующийся, беспокойный шумный, буйный, бурный [ t(j)uː'mʌlʧuəs ]
lurch		крен склонность, расположенность, тенденция   шаткая походка; пошатывание, шатание идти шатаясь, пошатываться двойная проигранная партия  (в криббидж, триктрак)  [ lɜːʧ ]
veer		менять направление, поворачивать перемена направления veer round   менять направление по часовой стрелке  травить  (канат)   [ vɪə ]
vent		выражение  (чувств) , выход входное или выходное отверстие; отдушина клапан  жерло вулкана дымоход; труба сделать отверстие   выпускать  (наружу)  выражать, высказывать; давать выход; изливать [ vent ] 
offending		проблемный, раздражающий [ ə'fendɪŋ ]
put through		выполнить, закончить  (работу)  соединять   принимать  (закон)   Syn: get through подготовить  []
swerve		отклонение  (от курса)  отклоняться, сворачивать бродить, скитаться (from)   отказываться от  (чего-л.)  [ swɜːv ]
bear down		(up)on)   устремляться; набрасываться, нападать, обрушиваться ;тяготить строго наказывать подходить с наветренной стороны тужиться при родах преодолеть, сломить [ beə ]
disarray		беспорядок; замешательство  приводить в беспорядок, замешательство, раздевать, снимать одежду [ ˌdɪs(ə)'reɪ ]
gaggle		стадо гусей толпа  (обычно шумная)  гоготанье  гоготать  [ 'gægl ]
milling		топтание по кругу   рифлёный гурт монеты помол молотьба; дробление, измельчение трёпка, взбучка [ 'mɪlɪŋ ]
to give smb. a fright		напугать кого-л. []
unworthy		низкий, подлый незаслуженный ничего не стоящий, не имеющий ценности [ ʌn'wɜːðɪ ]
and no mistake, make no mistake		несомненно, бесспорно; непременно, обязательно []
armful		охапка [ 'ɑːmful ]
fizz		шампанское; шипучий напиток шипеть, пениться, проявлять волнение, выказывать радость   свистеть суета, неразбериха [ fɪz ]
bury		  похоронить, предать забвению ; in(to) погружать; скрывать, прятать погружаться; прятаться, скрываться,[ 'berɪ ]
quarry		добыча; преследуемый зверь намеченная жертва   источник сведений рыться  (в чём-л.) ; выискивать, добывать разрабатывать карьер, каменоломня [ 'kwɔrɪ ]
flat out		на максимальной скорости   совершенно, совсем, абсолютно открыто, прямо [ ˌflæt'aut ]
litter		  сорить, мусорить ,разбросанные вещи, беспорядок сор, мусор быть в большом количестве, изобиловать производить детёнышей   палый лист и хворост;приплод, помёт наполнитель для кошачьих туалетов подстилка [ 'lɪtə ]
carry on		продолжать вести  (дело)  флиртовать;иметь любовную связь вести себя запальчиво, грубо;[]
startle		испугать; поразить побуждать  (к) вздрагивать бросаться в сторону, пугаться испуг; страх; [ 'stɑːtl ]
----------------16:34 Friday, March 13, 2020------------------
board up		заколотить досками []
wealth		  богатство, состояние   изобилие, избыток;богатства [ welθ ] 
scamper		бегать, носиться, резво скакать   быстрый бег; пробежка беглое прочтение, быстрый просмотр [ 'skæmpə ]
run for it		мчаться изо всех сил []
put out		расстраивать ,выводить из себя, смущать, причинять неудобство расходовать, тратить   выкалывать  (глаз)  выгонять; удалять, устранять давать побеги вывихнуть тушить, гасить []
averting		предотвращение, предохранение, предупреждение Syn: preventing  [ ə'vɜːtɪŋ ]
pang		  страдания, душевная боль, угрызения совести внезапная острая боль,  причинять острую боль [ pæŋ ]
uncharacteristic		нетипичный, нехарактерный [ ˌʌnkærəkt(ə)'rɪstɪk ]
doggedly		  упрямо, не отходя от выбранного курса не ослабевая [ 'dɔgɪdlɪ ]
immense		безмерный, очень большой, обширный, очень просторный, необъятный;классный, крутой, потрясающий [ ɪ'men(t)s ] 
disquiet		 беспокойство, волнение, смятение, тревога беспокойный, беспокоить, волновать, тревожить [ dɪs'kwaɪət ]
hump		округлая выпуклость бугорок, кочка; горб решающий, критический момент; перелом ситуации; кульминация,тоска, плохое настроение; депрессия горбить, сутулить напрягаться; действовать энергично нагонять тоску; портить настроение взвалить на спину   быстро двигаться, мчаться трахаться [ hʌmp ]
chute		спуск; лоток, жёлоб,мусоропровод сокр. от parachute   стремнина крутой скат покатый настил; горка путь рыб, идущих на нерест [ ʃuːt ]
shack		лачуга, хижина, хибара  временно жить, обитать [ ʃæk ] 
crumble		терпеть крах, разрушаться, гибнуть сыпаться, осыпаться; обваливаться раскрошить, растолочь,[ 'krʌmbl ]
air of		 выражение ,air of dignity  — выражение достоинства air of luxury  — атмосфера роскоши [ eə ]
puddle		  лужа разг. , диал. грязь барахтаться в луже   забрызгивать грязью, пачкать месить  (глину)    мутить  (воду) смущать, [ 'pʌdl ] 
yield		уступать, пропускать вперёд; соглашаться    сдаваться; прекращать сопротивление подаваться, поддаваться платить, расплачиваться, пружинить растягиваться   приносить урожай,плоды, урожай текучесть [ jiːld ]
yield up the ghost		 отдать богу душу, умереть []
sludge		густая грязь; слякоть ил, тина шуга (плавающий лёд) осадок,очищать от грязи давать осадок,идти с трудом, устало тащиться [ slʌʤ ]
lob		зашвырнуть, бросить бежать тяжело, неуклюже высоко подбрасывать высокий мягкий удар; высоко брошенный мяч   густая жидкость [ lɔb ]
mildly		  неостро, некрепко тихо, спокойно; мягко снисходительно, милосердно, сострадательно умеренно [ 'maɪldlɪ ]
apparition		появление, явление  (особенно неожиданное)  видение; привидение, призрак видимость [ ˌæp(ə)'rɪʃ(ə)n ] 
striving		стремление; склонность, цель Syn: aspiration, libido, aspiring, objective, pursuit, tendency [ 'straɪvɪŋ ]
exceedingly		весьма, очень, сильно, чрезвычайно  Syn:  extraordinarily, extremely [ ɪk'siːdɪŋlɪ ], [ ek- ]
lesser		  прил.; сравн. ст. от  little  меньший the lesser of two evils  — меньшее из двух зол малый [ 'lesə ]
lure		соблазн привлекательность, притягательность завлекать, соблазнять приманка [ l(j)uə ] 
gloat		тайно злорадствовать, торжествовать ( over, upon)   пожирать глазами злорадство взгляд полный злорадства [ gləut ]















